P*****A*******B
*     *       *
*     *       *
R*****E       *
      *       *
      *       *
  F***K*******D