H******F******J
*      *      *
*      *      *
Y******L******G
*      *      *
K******A******B